{
    "0": "O1",
    "1": "O2",
    "2": "O3",
    "3": "O4",
    "4": "O5",
    "5": "O6",
    "6": "O7",
    "7": "A1",
    "8": "A2",
    "9": "A3",
    "10": "A4",
    "11": "O8",
    "12": "A5",
    "13": "O9",
    "14": "A6"
}