{
    "0": "A1",
    "1": "M1",
    "2": "A2",
    "3": "M2",
    "4": "M3",
    "5": "A3",
    "6": "A4",
    "7": "M4",
    "8": "M5",
    "9": "A5",
    "10": "A6"
}