{
    "0": "A1",
    "1": "O1",
    "2": "O2",
    "3": "A2",
    "4": "O3",
    "5": "O4"
}