{
    "0": "A1",
    "1": "A2",
    "2": "A3",
    "3": "O1",
    "4": "O2",
    "5": "O3",
    "6": "A4",
    "7": "O4"
}