{
    "0": "M1",
    "1": "M2",
    "2": "M3",
    "3": "M4",
    "4": "M5",
    "5": "M6",
    "6": "M7",
    "7": "A1",
    "8": "A2",
    "9": "A3",
    "10": "A4",
    "11": "M8",
    "12": "A5",
    "13": "M9",
    "14": "A6"
}