{
    "0": "A1",
    "1": "M1",
    "2": "M2",
    "3": "A2",
    "4": "M3",
    "5": "M4"
}