{
    "0": "A1",
    "1": "A2",
    "2": "A3",
    "3": "M1",
    "4": "M2",
    "5": "M3",
    "6": "A4",
    "7": "M4"
}