{
    "0": "O1",
    "1": "O2",
    "2": "O3",
    "3": "O4",
    "4": "O5",
    "5": "O6",
    "6": "O7"
}