{
    "0": "A1",
    "1": "O1",
    "2": "O2",
    "3": "A2",
    "4": "A3",
    "5": "A4",
    "6": "O3"
}