{
    "0": "A1",
    "1": "O1",
    "2": "A2",
    "3": "O2",
    "4": "O3",
    "5": "A3",
    "6": "A4",
    "7": "O4",
    "8": "O5",
    "9": "A5",
    "10": "A6"
}