{
    "0": "A1",
    "1": "M1",
    "2": "M2",
    "3": "A2",
    "4": "A3",
    "5": "A4",
    "6": "M3"
}